*G**********
*          *
* ******** *
*    *   * *
*** ** * * *
*      * * *
********S***
