*S**********
*          *
* ******** *
*    *   G *
*** ** * * *
*      * * *
************
